E ENEMY
C COIN
P PLAYER
H FOOD CHEESE
T FOOD TRASH
S COSMETIC

000000000000300000000000000000003000000000000000000030000000
0E0000000000300000000000000000003000000000000000000030000000
0000000033E3300000000000000033333000000000C0C0C0333330000000
000C000000003E0000000000000000003000CC0000101010000030000000
00000000000030F000000000000000003000110001000000000030000000
0000000000003000000000CC0000CCC03000000000000000000030000000
0000000000000000000000CC000111110000000000000000000000000000
000000022222000000000000000211120000000000000002222200000000
000000002222000000010000000021220000000000000000222200110000
000000000222000000010000000002220000S00000000000022200110000
000000000022000000010000000000220000000000000000002200000CCC
003P30000S0H000000110033300000020000001100333000000200000011
003330000CCC000S0011003330000CCC000E001100333000000000000011
00333000111110000011003E300011111000001100333000111110000011
111111111111111111111111111111111111111111111000111110000011
