E ENEMY
C COIN
P PLAYER
H FOOD CHEESE
T FOOD TRASH
S COSMETIC
B BOX

00000001111111110000000000000000000000000000000000
00000000000000000000000000000000000000000000000000
00000000000000000000000000000000000000000000000000
00000000000000000000000000000000000000000000000000
00000000000000000000000000000000000000000000000000
00000000000000000000000000000000000000000000000000
00000000000000000000000000000000000000000000000000
00000000000000000000000000000000000000000000000000
000000000000003000000000000011000000000CCCCC000000
000000000000033000000000000011110000000CCCCC000000
000000000000003000000000001111111000000CCCCC000000
000P00000000003300000000001111111000000CCCCC000000
0000000000000222000EEE00011111100000000CCCCCB00000
00000000000021112000000001111110000000000000000000
11111111111111111111111111111111111111111111111111
