00000000000030000000
00000000000030000000
00000000333330000000
00000000000030000000
00000000000030000000
00000000000030000000
00000000000000000000
00000002222200000000
00000000222200000000
00000000022200000000
00000000002200000000
00333000000200000011
00333000000000000011
00333000111110000011
11111111111111111111
