00000001111111110000000000000000000000000000000000
00000000000000000000000000000000000000000000000000
00000000000000000000000000000000000000000000000000
00000000000000000000000000000000000000000000000000
00000000000000000000000000000000000000000000000000
00000000000000000000000000000000000000000000000000
00000000000000000000000000000000000000000000000000
00000000000000000000000000000000000000000000000000
00000000000000300000000000001100000000000000000000
00000000000003300000000000001111000000000000000000
00000000000000300000000000111111100000000000000000
00000000000000330000000000111111100000000000000000
00000000000002220000000001111110000000000000000000
00000000000021112000000001111110000000000000000000
11111111111111111111111111111111111111111111111111
