000000011111111111110000000003111100000000000000111230000111
000000001111100001100000000003223000000000000000032230000011
000000003333300000000000000033333000000000000000333330000001
000000000000300000000000000000303000000000000000000300000001
000000000000300000000000000000303000110000131310000300000000
000000000000300000000000000000300000112221333000000300000000
000000000000000000000000000111110022222221300000000320000000
000000022222000000000000000111112222200220000002222222200000
000000002222200000011000000011122220000000000022222221110000
000000000222200000011000000002222200000000000002222221110000
000000000022000000111000000002222200000000000000000022200000
003330000222000000111333300022222000001100330000000000000111
003330000022200000112233300022220000001100333000000000000111
103330001111100000112223300011111000001100333000110000000111
111111111111111111111111111111111111111111111000110000000111
